NO textures/text.xpm
EA textures/6507104_37858.xpm


SO textures/text.xpm
WE textures/6507104_37858.xpm

C 20,     120,    190
F 66,  45,   44



111111111111111
111111000111111
111110000011111
111100000001111
111W00000000111
110000000000011
100001111100001
110000111000011
111000010000111
111100000001111
111110000011111
111111000111111
111111000111111
111111111111111
111111111111111
111110000011111
111100000001111
111000000000111
110000000000011
100001111100001
110000111000011
111000010000111
111100000001111
111110000011111
111111000111111
111111111111111

                      

               

