NO textures/red_wall.xpm
SO textures/wall_1.xpm
WE textures/wall_2.xpm
EA textures/wall.xpm

F 18,53,25
C 153,204,255

111111111111111111111111111111111111111111111111111111111111111111111111111111111111111111111111111111
100000000000000000000000000000000000000000000000000000000000000000000000000000000000000000000000000001
100000N00000000000000000000000000000000000000000000000000000000000000000000000000000000000000000000001
100000000000000000000000000000000000000000000001111111111111111111111111100000000000000000000000000001
10000000111000000000000111111111111100000000000000000000000000000000000000000000000000000010100000001
100000001110000000000000000000111111100000000000000000000010100000000000010000000000000000000000000001
100000001111111000000000000000000000100000000000000000000010100000000000010000000000000000010100000001
100000000000001000000000000000000000100000000000000000000010100000000000011110000000000000010100000001
100001111111111000000000000000000000100000000000000000000010100000000000000000000000000000010100000001
100000000000000000001110000000000000100000000000000000000010100000000000000000000000000000010100000001
100000000000000000001110000000000000100000000000000000000010100000000111111111111000000000010100000001
100000001111100000001110000000000000100000000000000000000000000000000000000100000000000000010100000001
100000001111100000000000000000000000111111110000000000000011100000000000000100000000000000000000000001
100000000000100000000000000000000000000000000000000000000010100000000000000100000000000000010100000001
100000000000100000000000000000000000000000000000000000000010100000000000000100000000000000010100000001
100000000000111100000000000000000000000000000000000000000010100000000000000100000000000000010100000001
100000000000111100000000000000000000000110000000000000000000000000000000000100000000000000010100000001
100000000000000000000000000000000000000110000000000000000011100000000000000000000000000000000000000001
100000000000000011111100000000000000000000000000000000000011100000000000000000000000000000011100000001
100000000000000000000000000000000000000000000000000000000011100000000000000000000000000000011100000001
100000000000000000000000000000000000000000000000000000000011100000000000000000000000000000000000000001
1111111111111111111111111111111111111111111111111111111111111111111111111111111111111111111111111111111
